xxxxxxxxxxxxxxx
xw___________wx
x_____________x
x_____________x
x_____________x
x____________1x
x_x___________x
e2xw_________px
x_x___________x
x____________1x
x_____________x
x_____________x
x___________w_x
xxxxxxxxxxxxxxx