xxxxxxxxxxxxxx
xw___________x
x____________x
x____________x
x____________x
x____________x
x____________x
e____2______px
x______1_____x
x____________x
x____________x
x____________x
x___________wx
xxxxxxxxxxxxxx